theme=grass
..........................
..........................
..........................
........###...............
..........................
......###.................
..........................
..............###.........
....................###...
..........###.............
S........E........E......F
##########..########..####
