theme=sand
..........................
..........................
.....###..................
..........................
..............###.........
..........................
....###...................
..........................
.................###......
S........................F
##########################
##########################
