theme=snow
..........................
.............###..........
..........................
.....###..................
..........................
..................###.....
..........................
.........###..............
..........................
S........................F
##########################
##########################
