theme=sand
..........................
..........................
..........................
.......###................
..........................
..............###.........
..........................
...###....................
....................###...
..........###.............
S.........E.........E....F
######..########..########