theme=grass
..........................
..........................
..........................
............###...........
..........................
......###.................
..........................
..............###.........
..........................
S........................F
##########################
##########################
