theme=purple
..........................
....###...................
..........................
..............###.........
..........................
.....###.............###..
..........................
...........###............
..........................
S........................F
##########################
##########################
