theme=dirt
..........................
..........................
.......###................
..........................
................###.......
..........................
....###...................
..........................
..............###.........
S........................F
##########################
##########################
